_______________
|             |
|      x      |
|     x  x    |
|  x          |
|             |
|             |
|             |
|             |
|             |
|             |
|             |
| ===     === |
| ===     === |
|      W      |
_______________