_______________
|    xxxxxx   |
|      xx     |
|      xx     |
|             |
|             |
|             |
|             |
|             |
|             |
|             |
|             |
| ===     === |
| ===     === |
|      W      |
_______________