_______________
|   xxxxxxx   |
|   x  x  x   |
|   x  x  x   |
|      x      |
|      x      |
|             |
|             |
|             |
|             |
|             |
|             |
| ===     === |
| ===     === |
|      W      |
_______________