_______________
|   xxxxxxx   |
|   x     x   |
|             |
|             |
|             |
|             |
|             |
|             |
|             |
|             |
|             |
| ===     === |
| ===     === |
|      W      |
_______________